R  0 0          
SO txt/wallb.xpm
F 140,140,140
NO txt/wallb.xpm
WE txt/wallb.xpm
C 102,204,255
S txt/wallo.xpm
EA txt/wallb.xpm


1111111111111
1000111000011
11101111N0011
1100000000011
111110011111111111111111111
100000000000100000000000001
100000000000000000000000001
100001111110000001111111111
111100000000001111111111111
111111111111111111111111111