R  1280 960         
SO txt/wolf/storm.xpm
F 102,51,0
NO txt/wolf/storm.xpm
WE txt/wolf/wpgreen.xpm
C 10,10,10
S1 txt/perso/coeur.xpm
S2 txt/spkies.xpm
EA txt/wolf/wpgreen.xpm



111     111
1S1     121
101     121
101     121
131     121
1011111110111111
1200004000333331
1111111111111111