R   1920 1080

SO txt/wallb.xpm
F 15,58,152
NO txt/walle.xpm
WE txt/wallo.xpm
C 255,0,255
S txt/barrel_side.xpm
EA txt/wallv.xpm


                     
1111111211111111
1111111011111111
1000000000000001
1000000000000001
1000000000000001
1000000000000001
1111111111111111
              
			       
				      

