R   500 500

SO txt/wallb.xpm
F 15,58,152
NO txt/walle.xpm
WE txt/wallo.xpm
C 255,0,255
S txt/barrel_side.xpm
EA txt/wallv.xpm






           111111111
           100000001
           111000111
           111111111