R   1920 1080

SO txt/walle.xpm
F 140,140,140
NO txt/wallv.xpm
WE txt/wallb.xpm
C 102,204,255
S txt/wallo.xpm
EA txt/wallo.xpm


                     
1111111211111111
1111111011111111
1000000000000001
1001000000000001
1000000001000001
1000000000000001
1000000200000001
1000000000000001
1111100000000001
1000000000000001
1111111111111111
              
			       
				      

