R  1920 1080          
SO txt/wolf/storm.xpm
F 102,51,0
NO txt/wolf/storm.xpm
WE txt/wolf/wpgreen.xpm
C 10,10,10
S1 txt/coeur.xpm
S2 txt/wolf/pique.xpm
EA txt/wolf/wpgreen.xpm


1111111111111
1000111000011
1110111100011
1100000000011
111114411111111111111111111
100000000000100000030000001
1000000030000002000N0000001
100301111110000301111111111
111100000002001111111111111
111111111111111111111111111

111
101
111