R  1280 920       
SO txt/wolf/storm.xpm
F 102,51,0
NO txt/wolf/storm.xpm
WE txt/wolf/wpgreen.xpm
C 10,10,10
S1 txt/perso/coeur.xpm
S2 txt/spkies.xpm
S3 txt/wolf/key.xpm
EA txt/wolf/wpgreen.xpm



1111111111111111111
1111000000400030111
111111111S011115111
1111110003331111111
1200033000000402511
1111511111111111111
1111111111111111111